####################
#                  #
#     #########    #
#     #S     ##    #
#     # ####  #    #
#     #    #  #    #
#     ### # # #    #
#     #     # #    #
#     # ### # #    #
#     #   #  ##    #
#     # ####E##    #
#     #########    #
#                  #
####################
