####################
#S                ##
#  #########  ######
#      #      ######
####  # ### ########
#    # #     #   ###
### ## # ##### # ###
#   #  #       #   #
## ##### ######### #
#        #         #
# ######## #### ####
######     ####   ##
###### ### ##   ####
######      E#    ##
####################