####################
#S          #      #
# #######  ## ######
#       #  #       #
####### #  #### ####
#       #  #      ##
### ######  # ## ###
#         #  # # # #
####### ## ## # ####
#     #      #  #  #
#  ####### #########
#          #       #
### ######## ## ####
#            #    ##
################E###