####################
#                  #
#                  #
#     ########     #
#     #S     #     #
#     # #### #     #
#     # #  # #     #
#     # # ## #     #
#     #    # #     #
#     # ####E#     #
#     ########     #
#                  #
#                  #
#                  #
####################