###################
#S       #         #
# ###### # ###### ##
# #      #       # #
# # ########### #  #
# #           # # ##
# ########### #   ##
#             # #  #
##### ########## # #
#                ###
### ######### ##  ##
#         #      ###
# ####### ######   #
#     E         # ##
####################
